+-+ +-+ +----- --+--------------+ +
 ***|***|E*******|8***************
+*+*+*+*+-+-+**+*|*+-----+ +------+
|*|**E|*8*|****|*+*|*************8|
|*| +*+-+*|*+**|E**|*------------*|
|*| |***| +*|*-+-+-+**************|
|*+-+*+*|***|**|***+-----+*+------|
|*|***|*+ + +-*|*+*+**************|
+*+*|*|***|*+**+*|***+---*------+*+
 8**|*|*+*|**G***|*+**8********E|*
+-+ +-+ +---+- --+---+----------- +
