+-----+-------+
|G****|*****8*|
|*+-+*|*****|*|
|*|8|*+-+*|*|*|
|*|*|*|8|*|*|*|
 *|*|*|*|***|*
|*|*****+-+*|*|
|*|*+-+***    |
|*|***+---+-=-|
|***|****8|EEE|
+---+----+----+
