----+-------+ -----
****|      G|
+--*|*+-----+-- --+
|***|*|***********|
|*+-+*|*+-------- |
|*|8****|         |
|*|*+-- +-=-+ +---|
|** |***|EEE|*****|
+-+***--+---+---+*|
****|*****8*****|*
----+-------- -----
